ZAWODNIK,KLUB,MECZE,PEŁNE,"W 1. ""11""",Z ŁAWKI,"W ""20""",CZAS
Lukas Hrosso,Cracovia,4,3,4,0,21,315
Karol Niemczycki,Cracovia,27,26,26,1,30,2385
Michal Peskovic,Cracovia,0,0,0,0,1,0
Adam Wilk,Cracovia,0,0,0,0,8,0
Krystian Bracik,Cracovia,0,0,0,0,1,0
Ołeksij Dytiatjew,Cracovia,0,0,0,0,7,0
Diego Ferraresso,Cracovia,8,2,5,3,29,440
Michael Gardawski,Cracovia,5,2,4,1,7,376
Michał Helik,Cracovia,1,1,1,0,2,90
David Jablonsky,Cracovia,2,2,2,0,2,180
Ivan Marquez,Cracovia,17,13,15,2,28,1308
Kamil Pestka,Cracovia,1,0,1,0,1,42
Mateusz Pieńczak,Cracovia,0,0,0,0,2,0
Cornel Rapa,Cracovia,30,27,29,1,30,2598
Luis Rocha,Cracovia,10,8,10,0,10,875
Matej Rodin,Cracovia,23,21,23,0,24,2058
Michal Siplak,Cracovia,13,6,10,3,13,857
Dawid Szymonowicz,Cracovia,24,19,20,4,28,1866
Jan Ziewiec,Cracovia,0,0,0,0,5,0
Marcin Budziński,Cracovia,2,0,1,1,4,67
Milan Dimun,Cracovia,23,8,14,9,25,1380
Ivan Fiolić,Cracovia,19,2,15,4,24,1120
Jakub Gut,Cracovia,1,0,0,1,1,5
Sergiu Hanca,Cracovia,21,12,21,0,21,1746
Jakub Kosecki,Cracovia,8,0,2,6,9,306
Florian Loshaj,Cracovia,23,6,14,9,26,1328
Sylwester Lusiusz,Cracovia,6,5,6,0,14,526
Maciej Mrozik,Cracovia,0,0,0,0,1,0
Jakub Myszor,Cracovia,1,0,0,1,6,28
Damir Sadiković,Cracovia,20,13,17,3,20,1530
Mateusz Supryn,Cracovia,0,0,0,0,1,0
Michał Rakoczy,Cracovia,0,0,0,0,2,0
Thiago,Cracovia,25,3,9,16,28,1038
Mateusz Wdowiak,Cracovia,3,1,2,1,3,214
Pelle van Amersfoort,Cracovia,28,26,28,0,28,2445
Tomas Vestenicky,Cracovia,11,0,3,8,13,394
Patryk Zaucha,Cracovia,7,0,6,1,18,347
Marcos Alvarez,Cracovia,21,2,16,5,22,1354
Przemysław Kapek,Cracovia,2,0,0,2,6,2
Daniel Pik,Cracovia,9,0,4,5,13,312
Filip Piszczek,Cracovia,22,0,4,18,25,657
Rivaldinho,Cracovia,24,2,18,6,26,1355
Sebastian Strózik,Cracovia,6,0,0,6,13,98
Martin Chudy,Górnik,30,30,30,0,30,2700
Jakub Grzesiak,Górnik,0,0,0,0,3,0
Dawid Kudła,Górnik,0,0,0,0,27,0
Bartosz Neugebauer,Górnik,0,0,0,0,4,0
Paweł Bochniewicz,Górnik,2,2,2,0,2,180
Stefanos Evangelou,Górnik,9,5,6,3,17,635
Adrian Gryszkiewicz,Górnik,27,26,27,0,27,2401
Erik Janza,Górnik,28,25,26,2,28,2423
Michał Koj,Górnik,14,10,11,3,23,983
Giannis Massouras,Górnik,23,8,20,3,24,1725
Kacper Michalski,Górnik,3,0,0,3,12,32
Aleksander Paluszek,Górnik,13,7,12,1,25,884
Przemysław Wiśniewski,Górnik,29,28,28,1,29,2565
Filip Bainović,Górnik,7,0,0,7,11,110
Bartłomiej Eizenchart,Górnik,0,0,0,0,11,0
Wojciech Hajda,Górnik,4,0,0,4,9,17
Jesus Jimenez,Górnik,29,23,28,1,29,2551
Krzysztof Kubica,Górnik,22,10,14,8,24,1278
Alasana Manneh,Górnik,27,9,21,6,27,1906
Bartosz Nowak,Górnik,29,11,25,4,30,2154
Roman Prochazka,Górnik,28,7,19,9,30,1705
Michał Rostkowski,Górnik,11,0,5,6,18,324
Adam Ryczkowski,Górnik,5,0,0,5,13,90
Daniel Ściślak,Górnik,20,0,4,16,27,642
Norbert Wojtuszek,Górnik,14,1,7,7,23,601
Richmond Boakye,Górnik,13,2,7,6,13,740
Piotr Krawczyk,Górnik,26,1,8,18,28,1112
Dariusz Pawłowski,Górnik,10,4,9,1,20,702
Alex Sobczyk,Górnik,26,0,21,5,27,1235
Łukasz Wolsztyński,Górnik,2,0,0,2,4,5
Xavier Dziekoński,Jagiellonia,16,15,15,1,25,1401
Jakub Jasionek,Jagiellonia,0,0,0,0,1,0
Pavels Steinbors,Jagiellonia,10,9,10,0,22,849
Damian Węglarz,Jagiellonia,5,5,5,0,13,450
Zoran Arsenić,Jagiellonia,1,1,1,0,1,90
Błażej Augustyn,Jagiellonia,24,16,21,3,24,1796
Bodvar Bodvarsson,Jagiellonia,13,8,9,4,13,885
Andrej Kadlec,Jagiellonia,3,0,0,3,4,63
Jan Majsterek,Jagiellonia,0,0,0,0,5,0
Miłosz Matysik,Jagiellonia,1,0,0,1,8,7
Myrosław Mazur,Jagiellonia,3,2,2,1,12,181
Bojan Nastić,Jagiellonia,9,5,9,0,9,687
Paweł Olszewski,Jagiellonia,17,13,17,0,18,1453
Szymon Pankiewicz,Jagiellonia,2,1,2,0,4,165
Ivan Runje,Jagiellonia,15,13,14,1,18,1235
Godfrey Stephen,Jagiellonia,3,2,2,1,9,208
Bogdan Tiru,Jagiellonia,25,18,23,2,28,2028
Bartłomiej Wdowik,Jagiellonia,21,8,17,4,23,1471
Maciej Bortniczuk,Jagiellonia,11,0,1,10,15,143
Ariel Borysiuk,Jagiellonia,15,2,5,10,20,599
Juan Camara,Jagiellonia,2,0,1,1,2,51
Fedor Cernych,Jagiellonia,16,0,9,7,18,855
Fernan Ferreiroa,Jagiellonia,11,0,6,5,19,405
Jesus Imaz,Jagiellonia,27,20,25,2,27,2267
Bartosz Kwiecień,Jagiellonia,12,1,7,5,12,610
Maciej Makuszewski,Jagiellonia,23,2,17,6,26,1372
Przemysław Mystkowski,Jagiellonia,18,1,10,8,23,856
Jakub Orpik,Jagiellonia,1,0,1,0,5,60
Martin Pospisil,Jagiellonia,29,18,26,3,29,2356
Tomas Prikryl,Jagiellonia,18,10,13,5,18,1235
Taras Romanczuk,Jagiellonia,25,21,23,2,25,2088
Kris Twardek,Jagiellonia,15,3,8,7,23,668
Kamil Wojtkowski,Jagiellonia,7,0,1,6,10,181
Konrad Wrzesiński,Jagiellonia,7,0,2,5,7,225
Mateusz Wyjadłowski,Jagiellonia,3,0,0,3,9,55
Bartosz Bida,Jagiellonia,17,1,7,10,25,717
Jakub Lutostański,Jagiellonia,0,0,0,0,1,0
Jakov Puljić,Jagiellonia,25,7,21,4,25,1864
Szymon Sobczak,Jagiellonia,1,0,0,1,6,13
Krzysztof Toporkiewicz,Jagiellonia,1,0,0,1,7,4
Maciej Twarowski,Jagiellonia,1,0,0,1,3,14
Krzysztof Bąkowski,Lech,0,0,0,0,1,0
Filip Bednarek,Lech,15,15,15,0,30,1350
Marko Malenica,Lech,0,0,0,0,14,0
Mickey van der Hart,Lech,15,15,15,0,15,1350
Filip Borowski,Lech,0,0,0,0,9,0
Bohdan Butko,Lech,3,1,1,2,6,119
Dorde Crnomarković,Lech,8,6,7,1,11,636
Alan Czerwiński,Lech,25,20,22,3,27,1966
Tomasz Dejewski,Lech,5,3,3,2,23,329
Robert Gumny,Lech,1,1,1,0,2,90
Wołodymyr Kostewycz,Lech,0,0,0,0,1,0
Wasyl Kraweć,Lech,18,8,10,8,22,938
Antonio Milić,Lech,9,8,8,1,12,765
Jakub Niewiadomski,Lech,0,0,0,0,4,0
Krystian Palacz,Lech,3,0,0,3,6,28
Tymoteusz Puchacz,Lech,27,15,22,5,27,1983
Thomas Rogne,Lech,18,14,18,0,27,1509
Bartosz Salamon,Lech,13,12,12,1,15,1082
Lubomir Satka,Lech,17,17,17,0,22,1530
Patryk Waliś,Lech,0,0,0,0,1,0
Kamil Jóźwiak,Lech,2,0,2,0,2,150
Jakub Kamiński,Lech,28,9,25,3,28,2003
Jesper Karlstrom,Lech,16,9,15,1,16,1224
Tymoteusz Klupś,Lech,0,0,0,0,2,0
Antoni Kozubal,Lech,1,0,0,1,4,7
Nika Kwekweskiri,Lech,12,4,6,6,15,613
Filip Marchwiński,Lech,21,2,5,16,29,636
Jakub Moder,Lech,14,11,14,0,14,1211
Karlo Muhar,Lech,6,0,2,4,14,146
Dani Ramirez,Lech,30,5,27,3,30,2126
Michał Skóraś,Lech,26,5,14,12,26,1479
Jan Sykora,Lech,22,2,14,8,22,1181
Pedro Tiba,Lech,28,22,25,3,28,2306
Mohammad Awwad,Lech,9,0,1,8,13,237
Mikael Ishak,Lech,22,9,21,1,22,1681
Aron Johannsson,Lech,9,0,5,4,11,519
Nika Kaczarawa,Lech,7,0,1,6,7,108
Norbert Pacławski,Lech,2,0,0,2,4,5
Hubert Sobol,Lech,3,0,0,3,3,82
Filip Szymczak,Lech,11,1,2,9,17,311
Zlatan Alomerović,Lechia,2,2,2,0,25,180
Dusan Kuciak,Lechia,28,28,28,0,30,2520
Antoni Mikułko,Lechia,0,0,0,0,1,0
Eryk Mirus,Lechia,0,0,0,0,4,0
Karol Fila,Lechia,26,13,19,7,28,1774
Rafał Kobryń,Lechia,1,0,1,0,4,45
Bartosz Kopacz,Lechia,29,26,27,2,29,2454
Mario Maloca,Lechia,15,12,13,2,26,1218
Mykoła Musolitin,Lechia,3,0,0,3,10,64
Michał Nalepa II,Lechia,16,12,15,1,17,1292
Rafał Pietrzak,Lechia,26,19,24,2,30,2106
Kristers Tobers,Lechia,17,14,15,2,20,1318
Jan Biegański,Lechia,13,7,12,1,16,932
Joseph Ceesay,Lechia,11,0,7,4,11,532
Conrado,Lechia,27,5,20,7,27,1595
Maciej Gajos,Lechia,28,7,20,8,30,1732
Omran Haydary,Lechia,18,1,12,6,26,979
Jakub Kałuziński,Lechia,11,1,6,5,22,540
Filip Koperski,Lechia,1,0,0,1,4,15
Egzon Kryeziu,Lechia,2,1,1,1,16,102
Jarosław Kubicki,Lechia,28,23,27,1,28,2440
Tomasz Makowski,Lechia,19,7,14,5,21,1290
Jaroslav Mihalik,Lechia,9,0,3,6,11,300
Egy Maulana Vikri,Lechia,7,0,0,7,26,84
Flavio Paixao,Lechia,30,18,28,2,30,2382
Kenny Saief,Lechia,22,0,16,6,22,1345
Mateusz Sopoćko,Lechia,4,0,1,3,7,118
Żarko Udovicić,Lechia,14,0,5,9,18,538
Kacper Urbański,Lechia,1,0,0,1,8,10
Jakub Arak,Lechia,4,0,0,4,5,45
Łukasz Zwoliński,Lechia,22,10,13,9,23,1403
Mateusz Żukowski,Lechia,16,0,1,15,25,231
Artur Boruc,Legia,25,23,25,0,28,2160
Radosław Cierzniak,Legia,1,0,0,1,10,45
Cezary Miszta,Legia,6,5,5,1,19,495
Kacper Tobiasz,Legia,0,0,0,0,5,0
Inaki Astiz,Legia,0,0,0,0,3,0
Mateusz Hołownia,Legia,9,6,8,1,18,655
Artur Jędrzejczyk,Legia,27,27,27,0,28,2430
Josip Juranović,Legia,26,24,25,1,27,2231
Michał Karbownik,Legia,8,2,7,1,9,575
Igor Lewczuk,Legia,11,9,10,1,17,882
Filip Mladenović,Legia,29,25,27,2,29,2419
Ariel Mosór,Legia,0,0,0,0,3,0
Nikodem Niski,Legia,0,0,0,0,1,0
William Remy,Legia,3,3,3,0,4,270
Luis Rocha,Legia,2,0,2,0,12,139
Paweł Stolarski,Legia,4,1,2,2,14,211
Artem Szabanow,Legia,7,4,6,1,7,538
Marko Vesović,Legia,1,0,0,1,5,27
Mateusz Wieteska,Legia,18,17,17,1,22,1575
Domagoj Antolić,Legia,8,1,3,5,9,323
Mateusz Cholewiak,Legia,4,0,0,4,17,71
Radosław Cielemęcki,Legia,0,0,0,0,1,0
Walerian Gwilia,Legia,19,2,10,9,22,914
Bartosz Kapustka,Legia,25,12,22,3,25,1868
Jakub Kisiel,Legia,3,0,0,3,11,47
Luquinhas,Legia,25,14,21,4,25,1974
Andre Martins,Legia,25,11,22,3,29,1704
Kacper Skibicki,Legia,6,0,2,4,17,218
Bartosz Slisz,Legia,27,19,25,2,27,2128
Joel Valencia,Legia,8,1,4,4,12,341
Paweł Wszołek,Legia,24,11,18,6,26,1578
Jasur Yaxshiboyev,Legia,1,0,0,1,7,12
Jose Kante,Legia,4,1,3,1,5,267
Kacper Kostorz,Legia,6,0,0,6,13,119
Rafael Lopes,Legia,20,2,8,12,26,893
Ernest Muci,Legia,6,1,2,4,12,236
Tomas Pekhart,Legia,25,15,23,2,25,2048
Nazarij Rusyn,Legia,0,0,0,0,1,0
Maciej Rosołek,Legia,8,1,2,6,14,252
Szymon Włodarczyk,Legia,2,0,1,1,8,55
Frantisek Plach,Piast,30,30,30,0,30,2700
Jakub Szmatuła,Piast,0,0,0,0,28,0
Karol Szymański,Piast,0,0,0,0,3,0
Jakub Czerwiński,Piast,26,26,26,0,26,2340
Maksym Gendera,Piast,0,0,0,0,2,0
Tomas Huk,Piast,24,23,23,1,26,2079
Mikkel Kirkeskov,Piast,7,7,7,0,7,630
Martin Konczkowski,Piast,25,20,21,4,25,2037
Piotr Malarczyk,Piast,14,11,14,0,27,1179
Tomasz Mokwa,Piast,4,2,2,2,13,215
Bartosz Rymaniak,Piast,13,6,10,3,24,778
Tiago Alves,Piast,21,0,4,17,25,591
Gerard Badia,Piast,22,0,15,7,24,1139
Remigiusz Borkała,Piast,0,0,0,0,9,0
Michał Chrapek,Piast,23,5,21,2,23,1662
Jakub Holubek,Piast,23,19,22,1,27,1971
Javier Ajenjo Hyjek,Piast,1,0,0,1,13,18
Tomasz Jodłowiec,Piast,27,8,14,13,27,1402
Patryk Lipski,Piast,25,6,12,13,28,1242
Sebastian Milewski,Piast,18,4,10,8,24,841
Arkadiusz Pyrka,Piast,23,1,8,15,28,898
Michał Rakowiecki,Piast,1,0,0,1,3,7
Patryk Sokołowski,Piast,29,17,28,1,29,2367
Kristopher Vida,Piast,19,2,10,9,27,893
Mateusz Winciersz,Piast,2,0,0,2,14,11
Michał Zachciał,Piast,0,0,0,0,1,0
Piotr Parzyszek,Piast,4,0,3,1,4,213
Karol Stanek,Piast,0,0,0,0,3,0
Dominik Steczyk,Piast,26,6,22,4,26,1773
Jakub Świerczok,Piast,23,7,20,3,23,1691
Michał Żyro,Piast,26,5,8,18,26,1023
Arkadiusz Leszczyński,Podbeskidzie,0,0,0,0,9,0
Rafał Leszczyński,Podbeskidzie,3,3,3,0,14,270
Michal Peskovic,Podbeskidzie,22,22,22,0,22,1980
Martin Polacek,Podbeskidzie,5,5,5,0,15,450
Dmytro Baszłaj,Podbeskidzie,15,14,14,1,28,1269
Kacper Gach,Podbeskidzie,12,11,12,0,14,1053
Jakub Hora,Podbeskidzie,16,5,13,3,16,1131
Rafał Janicki,Podbeskidzie,13,13,13,0,13,1170
Bartosz Jaroch,Podbeskidzie,5,2,3,2,6,288
Aleksander Komor,Podbeskidzie,12,10,11,1,13,1011
Petar Mamić,Podbeskidzie,12,5,12,0,14,955
Filip Modelski,Podbeskidzie,23,21,22,1,24,1994
Szymon Mroczko,Podbeskidzie,4,0,2,2,8,157
David Niepsuj,Podbeskidzie,9,1,7,2,9,523
Kornel Osyra,Podbeskidzie,2,2,2,0,5,180
Milan Rundić,Podbeskidzie,21,19,20,1,26,1787
Marco Tulio,Podbeskidzie,10,1,3,7,11,336
Jakub Bieroński,Podbeskidzie,15,2,11,4,27,824
Karol Danielak,Podbeskidzie,26,7,17,9,28,1478
Rafał Figiel,Podbeskidzie,8,1,6,2,12,454
Dominik Frelek,Podbeskidzie,9,0,1,8,18,302
Konrad Gutowski,Podbeskidzie,4,0,1,3,7,128
Gergo Kocsis,Podbeskidzie,19,7,13,6,23,1178
Filip Laskowski,Podbeskidzie,7,0,2,5,10,297
Mateusz Marzec,Podbeskidzie,16,0,7,9,19,682
Serhij Miakuszko,Podbeskidzie,15,0,2,13,17,345
Tomasz Nowak,Podbeskidzie,11,2,8,3,14,673
Michał Rzuchowski,Podbeskidzie,26,13,22,4,29,1943
Łukasz Sierpina,Podbeskidzie,22,3,12,10,28,1130
Maksymilian Sitek,Podbeskidzie,18,2,12,6,25,983
Desley Ubbink,Podbeskidzie,16,1,8,8,24,693
Kamil Biliński,Podbeskidzie,26,11,23,3,26,1932
Bartłomiej Kręcichwost,Podbeskidzie,2,0,1,1,2,84
Ivan Martin,Podbeskidzie,4,0,0,4,8,40
Marko Roginić,Podbeskidzie,22,10,16,6,22,1481
Peter Wilson,Podbeskidzie,13,0,4,9,13,416
Jakub Bursztyn,Pogoń,0,0,0,0,30,0
Dante Stipica,Pogoń,30,30,30,0,30,2700
Jakub Bartkowski,Pogoń,21,14,18,3,29,1640
Igor Łasicki,Pogoń,1,0,0,1,8,1
Mariusz Malec,Pogoń,20,16,17,3,27,1548
Luis Mata,Pogoń,18,6,15,3,21,1267
Hubert Matynia,Pogoń,14,8,13,1,15,969
Bartłomiej Mruk,Pogoń,1,0,0,1,3,1
David Stec,Pogoń,10,8,9,1,17,787
Paweł Stolarski,Pogoń,5,3,3,2,11,279
Kostas Triantafyllopoulos,Pogoń,17,16,17,0,24,1502
Benedikt Zech,Pogoń,27,25,26,1,27,2388
Damian Dąbrowski,Pogoń,26,17,25,1,28,2140
Kamil Drygas,Pogoń,27,1,16,11,29,1403
Mariusz Fornalczyk,Pogoń,6,0,0,6,19,68
Alexander Gorgon,Pogoń,24,10,20,4,24,1747
Santeri Hostikka,Pogoń,12,0,3,9,18,362
Sebastian Kowalczyk,Pogoń,29,7,26,3,29,2098
Kacper Kozłowski,Pogoń,20,0,14,6,23,1059
Michał Kucharczyk,Pogoń,30,15,26,4,30,2282
Rafał Kurzawa,Pogoń,10,3,6,4,10,582
Tomas Podstawski,Pogoń,20,2,4,16,27,522
Kacper Smoliński,Pogoń,27,0,8,19,28,954
Hubert Turski,Pogoń,1,0,0,1,2,7
Maciej Żurawski,Pogoń,7,0,4,3,11,344
Adrian Benedyczak,Pogoń,25,1,10,15,28,1000
Paweł Cibicki,Pogoń,4,0,1,3,6,113
Adam Frączczak,Pogoń,15,2,4,11,20,450
Luka Zahović,Pogoń,25,2,15,10,26,1418
Dominik Holec,Raków,16,16,16,0,16,1440
Branislav Pindroch,Raków,2,2,2,0,28,180
Jakub Szumski,Raków,12,12,12,0,14,1080
Kacper Trelowski,Raków,0,0,0,0,2,0
Zoran Arsenić,Raków,9,8,9,0,10,793
Jarosław Jach,Raków,10,6,9,1,16,777
Oskar Krzyżak,Raków,0,0,0,0,1,0
Petar Mamić,Raków,0,0,0,0,7,0
Daniel Mikołajewski,Raków,3,1,2,1,18,142
Andrzej Niewulis,Raków,23,18,19,4,29,1738
Tomas Petrasek,Raków,8,8,8,0,8,720
Kamil Piątkowski,Raków,27,27,27,0,27,2430
Maciej Wilusz,Raków,10,8,10,0,13,830
Daniel Bartl,Raków,11,0,4,7,16,371
Marcin Cebula,Raków,24,1,17,7,24,1485
Wiktor Długosz,Raków,6,0,3,3,15,192
Iwo Kaczmarski,Raków,2,0,2,0,8,90
Patryk Kun,Raków,29,20,26,3,29,2367
Ben Lederman,Raków,13,2,4,9,21,485
Piotr Malinowski,Raków,15,0,0,15,23,121
Piotr Owczarek,Raków,0,0,0,0,2,0
Giannis Papanikolaou,Raków,7,0,1,6,18,107
Marko Poletanović,Raków,21,6,18,3,26,1470
Igor Sapała,Raków,24,22,23,1,24,2062
Petr Schwarz,Raków,27,11,15,12,28,1553
Daniel Szelągowski,Raków,16,0,2,14,22,271
David Tijanić,Raków,28,6,24,4,28,1980
Fran Tudor,Raków,29,15,26,3,29,2350
Mateusz Wdowiak,Raków,9,0,4,5,13,330
Jakub Arak,Raków,12,0,3,9,13,432
Felicio Brown Forbes,Raków,1,0,0,1,2,19
Vladislavs Gutkovskis,Raków,29,5,24,5,29,1966
Ivi Lopez,Raków,26,5,17,9,27,1576
Sebastian Musiolik,Raków,4,0,0,4,4,43
Oskar Zawada,Raków,7,0,3,4,8,237
Mateusz Dudek,Stal,0,0,0,0,1,0
Michał Gliwa,Stal,5,5,5,0,27,450
Damian Primel,Stal,1,0,0,1,7,1
Rafał Strączek,Stal,25,24,25,0,27,2249
Wojciech Błyszko,Stal,3,1,2,1,11,198
Mateusz Bodzioch,Stal,0,0,0,0,1,0
Bożidar Czorbadżijski,Stal,20,13,19,1,22,1636
Jonathan de Amo,Stal,12,7,11,1,14,873
Marcin Flis,Stal,28,21,25,3,29,2285
Krystian Getinger,Stal,29,24,28,1,29,2411
Albin Granlund,Stal,12,3,11,1,14,744
Kamil Kościelny,Stal,14,13,14,0,14,1240
Wojciech Lisowski,Stal,3,0,1,2,13,63
Łukasz Seweryn,Stal,1,0,0,1,9,23
Martin Sus,Stal,6,0,0,6,8,165
Mateusz Żyro,Stal,20,14,15,5,26,1359
Robert Dadok,Stal,24,2,8,16,29,992
Maciej Domański,Stal,30,11,28,2,30,2210
Petteri Forsell,Stal,26,4,15,11,26,1432
Przemysław Maj,Stal,1,0,0,1,3,17
Mateusz Mak,Stal,25,4,12,13,25,1230
Mateusz Matras,Stal,27,19,25,2,29,2188
Damian Pawłowski,Stal,7,0,2,5,17,187
Andreja Prokić,Stal,29,1,15,14,29,1258
Szymon Stasik,Stal,4,1,2,2,6,182
Grzegorz Tomasiewicz,Stal,29,22,28,1,29,2476
Maciej Urbańczyk,Stal,11,8,9,2,24,836
Michael Wyparło,Stal,0,0,0,0,1,0
Kacper Sadłocha,Stal,2,0,0,2,14,13
Maciej Jankowski,Stal,11,1,6,5,14,544
Aleksandyr Kolew,Stal,15,2,11,4,15,910
Jakub Wróbel,Stal,8,0,2,6,9,261
Paweł Tomczyk,Stal,11,0,1,10,11,350
Łukasz Zjawiński,Stal,24,0,10,14,29,909
Bartłomiej Frasik,Śląsk,0,0,0,0,5,0
Matus Putnocky,Śląsk,19,19,19,0,23,1710
Dariusz Szczerbal,Śląsk,0,0,0,0,2,0
Michał Szromnik,Śląsk,11,11,11,0,29,990
Miłosz Tysiak,Śląsk,0,0,0,0,1,0
Łukasz Bejger,Śląsk,11,10,10,1,14,937
Piotr Celeban,Śląsk,14,13,13,1,18,1187
Guillermo Cotugno,Śląsk,9,5,6,3,15,554
Wojciech Golla,Śląsk,8,8,8,0,8,720
Patryk Janasik,Śląsk,17,10,14,3,18,1195
Lubambo Musonda,Śląsk,17,4,14,3,19,1132
Mariusz Pawelec,Śląsk,10,3,8,2,26,626
Konrad Poprawa,Śląsk,6,4,5,1,7,471
Israel Puerto,Śląsk,17,17,17,0,20,1530
Dino Stiglec,Śląsk,25,20,24,1,26,2102
Mark Tamas,Śląsk,24,20,22,2,29,2029
Maciej Wilusz,Śląsk,0,0,0,0,2,0
Olivier Wypart,Śląsk,0,0,0,0,1,0
Przemysław Bargiel,Śląsk,3,0,0,3,4,16
Bartosz Boruń,Śląsk,0,0,0,0,4,0
Szymon Lewkot,Śląsk,7,3,4,3,18,398
Jakub Łabojko,Śląsk,3,2,3,0,3,267
Adrian Łyszczarz,Śląsk,2,0,0,2,9,16
Rafał Makowski,Śląsk,11,1,3,8,20,340
Krzysztof Mączyński,Śląsk,18,16,18,0,19,1574
Maciej Pałaszewski,Śląsk,13,3,7,6,21,630
Bartłomiej Pawłowski,Śląsk,22,3,13,9,26,1190
Robert Pich,Śląsk,30,11,27,3,30,2361
Mateusz Praszelik,Śląsk,26,6,21,5,26,1754
Mathieu Scalet,Śląsk,14,6,10,4,23,879
Waldemar Sobota,Śląsk,28,7,17,11,28,1576
Marcin Szpakowski,Śląsk,2,0,0,2,6,18
Marcel Zylla,Śląsk,20,0,7,13,22,694
Sebastian Bergier,Śląsk,2,0,0,2,4,6
Erik Exposito,Śląsk,27,5,22,5,27,1863
Fabian Piasecki,Śląsk,26,1,6,20,27,723
Piotr Samiec-Talar,Śląsk,8,0,1,7,13,157
Daniel Bielica,Warta,5,5,5,0,30,450
Adrian Lis,Warta,25,25,25,0,30,2250
Leo Przybylak,Warta,0,0,0,0,1,0
Jan Grzesik,Warta,27,16,26,1,28,2262
Robert Ivanov,Warta,22,21,21,1,27,1892
Bartosz Kieliba,Warta,14,13,14,0,14,1183
Jakub Kiełb,Warta,23,19,21,2,26,1925
Jakub Kuzdra,Warta,23,19,21,2,27,1870
Aleks Ławniczak,Warta,23,21,22,1,26,2039
Filip Małek,Warta,0,0,0,0,3,0
Maik Nawrocki,Warta,3,2,2,1,12,195
Mateusz Spychała,Warta,7,0,4,3,22,317
Makana Baku,Warta,13,6,12,1,13,1073
Bartłomiej Burman,Warta,4,0,1,3,11,95
Mateusz Czyżycki,Warta,22,3,12,10,29,1047
Konrad Handzlik,Warta,3,0,0,3,14,44
Michał Jakóbowski,Warta,23,10,20,3,23,1713
Robert Janicki,Warta,19,0,7,12,29,661
Michał Kopczyński,Warta,7,3,5,2,9,393
Mateusz Kupczak,Warta,25,19,20,5,25,1905
Adrian Laskowski,Warta,9,5,7,2,11,580
Mario Rodriguez,Warta,13,0,5,8,15,425
Mariusz Rybicki,Warta,13,3,8,5,20,673
Dominik Smykowski,Warta,0,0,0,0,9,0
Mateusz Sopoćko,Warta,2,0,0,2,12,12
Kajetan Szmyt,Warta,6,1,1,5,14,183
Łukasz Trałka,Warta,29,23,28,1,29,2504
Maciej Żurawski,Warta,15,2,12,3,15,1009
Gracjan Jaroch,Warta,14,1,2,12,22,307
Mateusz Kuzimski,Warta,29,15,24,5,29,2160
Adam Zrelak,Warta,8,1,5,3,9,466
Kamil Broda,Wisła K,0,0,0,0,16,0
Michał Buchalik,Wisła K,3,3,3,0,17,270
Miłosz Jaskuła,Wisła K,0,0,0,0,2,0
Mateusz Lis,Wisła K,27,27,27,0,27,2430
Dawid Abramowicz,Wisła K,12,8,8,4,14,743
Łukasz Burliga,Wisła K,22,12,18,4,25,1626
Michal Frydrych,Wisła K,24,24,24,0,24,2160
Konrad Gruszkowski,Wisła K,7,0,4,3,14,398
Daniel Hoyo-Kowalski,Wisła K,1,0,0,1,17,2
Rafał Janicki,Wisła K,4,4,4,0,4,360
Lukas Klemenz,Wisła K,4,2,3,1,9,229
Souleymane Kone,Wisła K,7,5,5,2,13,459
Adi Mehremić,Wisła K,11,8,11,0,13,889
David Niepsuj,Wisła K,2,0,1,1,6,110
Uros Radaković,Wisła K,6,4,5,1,6,403
Maciej Sadlok,Wisła K,25,20,24,1,25,2138
Dawid Szot,Wisła K,20,8,15,5,24,1309
Serafin Szota,Wisła K,8,1,3,5,14,320
Krystian Wachowiak,Wisła K,1,0,0,1,8,22
Vullnet Basha,Wisła K,9,2,5,4,10,553
Jakub Błaszczykowski,Wisła K,16,1,3,13,16,485
Rafał Boguski,Wisła K,11,0,1,10,23,185
Chuca,Wisła K,13,4,10,3,21,805
Jean Carlos Silva,Wisła K,22,2,18,4,23,1389
Kacper Duda,Wisła K,0,0,0,0,7,0
Nikola Kuveljić,Wisła K,12,5,8,4,13,735
Michał Mak,Wisła K,4,0,1,3,7,92
David Mawutor,Wisła K,7,0,3,4,12,279
Patryk Plewka,Wisła K,17,16,17,0,19,1485
Stefan Savić,Wisła K,27,16,23,4,27,2059
Piotr Starzyński,Wisła K,15,5,10,5,16,911
Yaw Yeboah,Wisła K,28,11,26,2,28,2155
Gieorgij Żukow,Wisła K,25,13,21,4,25,1890
Fatos Bećiraj,Wisła K,10,1,1,9,12,282
Aleksander Buksa,Wisła K,13,0,1,12,19,162
Felicio Brown Forbes,Wisła K,22,10,22,0,22,1811
Zan Medved,Wisła K,13,1,5,8,16,530
Bartłomiej Gradecki,Wisła P,1,1,1,0,16,90
Krzysztof Kamiński,Wisła P,29,29,29,0,30,2610
Jakub Wrąbel,Wisła P,0,0,0,0,14,0
Angel Garcia,Wisła P,28,23,27,1,29,2389
Damian Michalski,Wisła P,13,8,10,3,28,923
Milan Obradović,Wisła P,8,6,6,2,14,609
Aleksander Pawlak,Wisła P,2,0,0,2,9,39
Julio Rodriguez,Wisła P,1,1,1,0,5,90
Jakub Rzeźniczak,Wisła P,21,18,21,0,21,1794
Bartłomiej Sielewski,Wisła P,1,0,0,1,1,6
Piotr Tomasik,Wisła P,14,10,12,2,20,1093
Alan Uryga,Wisła P,27,26,27,0,27,2377
Kristian Vallo,Wisła P,8,7,7,1,10,646
Damian Zbozień,Wisła P,18,16,17,1,28,1544
Paweł Żuk,Wisła P,3,0,2,1,7,201
Hubert Adamczyk,Wisła P,10,1,5,5,20,439
Maciej Ambrosiewicz,Wisła P,2,0,0,2,5,6
Fryderyk Gerbowski,Wisła P,0,0,0,0,3,0
Torgil Gjertsen,Wisła P,19,1,7,12,22,646
Kacper Kondracki,Wisła P,0,0,0,0,2,0
Dusan Lagator,Wisła P,26,19,21,5,27,1957
Filip Lesniak,Wisła P,26,21,24,2,29,2158
Giorgi Merebaszwili,Wisła P,10,2,3,7,17,404
Piotr Pyrdoł,Wisła P,15,0,2,13,20,332
Damian Rasak,Wisła P,26,8,23,3,27,1863
Luka Susnjara,Wisła P,4,0,1,3,10,119
Wojciech Szumilas,Wisła P,3,0,1,2,7,79
Mateusz Szwoch,Wisła P,30,15,27,3,30,2310
Jakub Witek,Wisła P,0,0,0,0,4,0
Rafał Wolski,Wisła P,7,0,3,4,8,324
Bartosz Zynek,Wisła P,1,0,0,1,3,16
Airam Cabrera,Wisła P,5,0,1,4,8,146
Dawid Kocyła,Wisła P,27,1,21,6,27,1727
Mateusz Lewandowski,Wisła P,16,0,6,10,19,545
Kacper Rogoziński,Wisła P,2,0,1,1,3,61
Cillian Sheridan,Wisła P,15,0,7,8,23,659
Patryk Tuszyński,Wisła P,25,4,17,8,27,1498
Konrad Forenc,Zagłębie,0,0,0,0,30,0
Dominik Hładun,Zagłębie,30,30,30,0,30,2700
Sasa Balić,Zagłębie,25,23,25,0,25,2167
Mateusz Bartolewski,Zagłębie,10,3,4,6,27,456
Kacper Chodyna,Zagłębie,24,21,22,2,24,2012
Dorde Crnomarković,Zagłębie,9,7,9,0,12,792
Lubomir Guldan,Zagłębie,14,14,14,0,14,1260
Dominik Jończy,Zagłębie,11,7,8,3,23,728
Kamil Kruk,Zagłębie,12,7,8,4,17,710
Damian Oko,Zagłębie,8,6,7,1,13,632
Milan Posmyk,Zagłębie,1,0,0,1,1,9
Soren Reese,Zagłębie,0,0,0,0,11,0
Lorenco Simić,Zagłębie,17,14,14,3,22,1275
Jakub Wójcicki,Zagłębie,11,6,8,3,29,711
Jewgienij Baszkirow,Zagłębie,25,14,20,5,30,1768
Jakub Bednarczyk,Zagłębie,8,1,3,5,17,288
Damjan Bohar,Zagłębie,4,2,4,0,4,358
Dejan Drazić,Zagłębie,22,4,19,3,23,1636
Daniel Dudziński,Zagłębie,0,0,0,0,5,0
Mateusz Kizyma,Zagłębie,0,0,0,0,1,0
Łukasz Łakomy,Zagłębie,8,0,0,8,15,123
Dawid Pakulski,Zagłębie,1,0,0,1,5,10
Łukasz Poręba,Zagłębie,24,8,18,6,25,1550
Adam Ratajczyk,Zagłębie,14,0,1,13,15,289
Filip Starzyński,Zagłębie,26,11,25,1,27,2082
Miroslav Stoch,Zagłębie,8,1,6,2,13,459
Jakub Sypek,Zagłębie,1,0,0,1,4,1
Sasa Zivec,Zagłębie,11,8,8,3,11,806
Jakub Żubrowski,Zagłębie,27,13,22,5,29,1789
Samuel Mraz,Zagłębie,27,0,13,14,30,1124
Karol Podliński,Zagłębie,12,4,12,0,12,948
Rok Sirk,Zagłębie,16,0,3,13,18,459
Oliwier Sławiński,Zagłębie,0,0,0,0,1,0
Patryk Szysz,Zagłębie,30,18,27,3,30,2418
