ZAWODNIK,KLUB,GOL,ASYSTY,KANADYJSKA,CZAS,MIN/GOL,MIN/G+AS
Jakub Świerczok,Zagłębie Lubin,16,3,19,1645,"102,8","86,6"
Łukasz Sekulski,Jagiellonia,4,2,6,600,"150,0","100,0"
Carlitos,Wisła Kraków,24,7,31,3198,"133,3","103,2"
Igor Angulo,Górnik Zabrze,22,3,25,2878,"130,8","115,1"
Miroslav Radović,Legia Warszawa,2,2,4,475,"237,5","118,8"
Christian Gytkjaer,Lech Poznań,19,1,20,2428,"127,8","121,4"
Jarosław Niezgoda,Legia Warszawa,13,2,15,1857,"142,8","123,8"
Krzysztof Piątek,Cracovia,21,4,25,3155,"150,2","126,2"
Adam Buksa,Zagłębie/Pogoń,5,2,7,942,"188,4","134,6"
Semir Stilić,Wisła Płock,4,8,12,1616,"404,0","134,7"
Marco Paixao,Lechia Gdańsk,16,2,18,2428,"151,8","134,9"
Maciej Makuszewski,Lech Poznań,5,5,10,1349,"269,8","134,9"
Nika Kaczarawa,Korona Kielce,7,6,13,1802,"257,4","138,6"
Adam Frączczak,Pogoń Szczecin,14,5,19,2662,"190,1","140,1"
Arvydas Novikovas,Jagiellonia,9,8,17,2382,"264,7","140,1"
Armando Sadiku,Legia Warszawa,2,4,6,846,"423,0","141,0"
Darko Jevtić,Lech Poznań,5,7,12,1746,"349,2","145,5"
Marcin Robak,Śląsk Wrocław,19,0,19,2812,"148,0","148,0"
Joao Oliveira,Lechia Gdańsk,3,2,5,768,"256,0","153,6"
Kamil Biliński,Wisła Płock,5,0,5,773,"154,6","154,6"
Goran Cvijanović,Korona Kielce,8,3,11,1737,"217,1","157,9"
Arkadiusz Piech,Śląsk Wrocław,10,3,13,2080,"208,0","160,0"
Mateusz Piątkowski,Wisła Płock,2,2,4,649,"324,5","162,3"
Kasper Hamalainen,Legia Warszawa,8,6,14,2293,"286,6","163,8"
Karol Świderski,Jagiellonia,5,2,7,1156,"231,2","165,1"
Michał Kucharczyk,Legia Warszawa,7,4,11,1836,"262,3","166,9"
Michal Papadopulos,Piast Gliwice,9,1,10,1721,"191,2","172,1"
Rafał Kurzawa,Górnik Zabrze,2,16,18,3145,"1572,5","174,7"
Jakub Mares,Zagłębie Lubin,4,3,7,1228,"307,0","175,4"
Gabriel Iancu,Bruk-Bet,2,2,4,702,"351,0","175,5"
Patryk Tuszyński,Zagłębie Lubin,5,1,6,1067,"213,4","177,8"
Jacek Kiełb,Korona Kielce,6,2,8,1481,"246,8","185,1"
Fedor Cernych,Jagiellonia,3,6,9,1669,"556,3","185,4"
Mateusz Szwoch,Arka Gdynia,10,4,14,2598,"259,8","185,6"
Łukasz Wolsztyński,Górnik Zabrze,4,7,11,2111,"527,8","191,9"
Damian Kądzior,Górnik Zabrze,10,5,15,2906,"290,6","193,7"
Sebastian Szymański,Legia Warszawa,4,2,6,1190,"297,5","198,3"
Jesus Imaz,Wisła Kraków,8,3,11,2188,"273,5","198,9"
Flavio Paixao,Lechia Gdańsk,10,3,13,2607,"260,7","200,5"
Cristian Pasquato,Legia Warszawa,2,3,5,1004,"502,0","200,8"
Jose Kante,Wisła Płock,9,1,10,2055,"228,3","205,5"
Elia Soriano,Korona Kielce,5,0,5,1043,"208,6","208,6"
Cillian Sheridan,Jagiellonia,6,1,7,1482,"247,0","211,7"
Adrian Danek,Sandecja,3,4,7,1483,"494,3","211,9"
Filip Starzyński,Zagłębie Lubin,6,3,9,1928,"321,3","214,2"
Sławomir Peszko,Lechia Gdańsk,4,5,9,1931,"482,8","214,6"
Deniss Rakels,Lech/Cracovia,1,4,5,1075,"1075,0","215,0"
Nico Varela,Wisła Płock,8,2,10,2162,"270,3","216,2"
Roman Bezjak,Jagiellonia,3,1,4,902,"300,7","225,5"
Giorgi Merebaszwili,Wisła Płock,5,5,10,2282,"456,4","228,2"
Kamil Jóźwiak,Lech Poznań,3,1,4,916,"305,3","229,0"
Filip Piszczek,Sandecja,6,2,8,1916,"319,3","239,5"
Karol Angielski,Piast Gliwice,2,2,4,959,"479,5","239,8"
Robert Pich,Śląsk Wrocław,6,5,11,2639,"439,8","239,9"
Jakub Kosecki,Śląsk Wrocław,4,4,8,1934,"483,5","241,8"
Roman Gergel,Bruk-Bet,3,3,6,1462,"487,3","243,7"
Aleksandyr Kolew,Sandecja,7,3,10,2459,"351,3","245,9"
Samuel Stefanik,Bruk-Bet,6,2,8,1993,"332,2","249,1"
Bartosz Kwiecień,Jagiellonia,3,1,4,1021,"340,3","255,3"
Gerard Badia,Piast Gliwice,2,2,4,1037,"518,5","259,3"
Patryk Lipski,Lechia Gdańsk,1,4,5,1302,"1302,0","260,4"
Sasa Zivec,Piast Gliwice,6,2,8,2086,"347,7","260,8"
Szymon Drewniak,Cracovia,0,6,6,1574,-,"262,3"
Milos Krasić,Lechia Gdańsk,1,4,5,1355,"1355,0","271,0"
Vladislavs Gutkovskis,Bruk-Bet,3,1,4,1092,"364,0","273,0"
Alan Uryga,Wisła Płock,4,1,5,1372,"343,0","274,4"
Mario Situm,Lech Poznań,2,4,6,1671,"835,5","278,5"
Michał Helik,Cracovia,8,2,10,2802,"350,3","280,2"
Ruben Jurado,Arka Gdynia,5,0,5,1402,"280,4","280,4"
Przemysław Frankowski,Jagiellonia,4,5,9,2565,"641,3","285,0"
Rafał Siemaszko,Arka Gdynia,5,0,5,1444,"288,8","288,8"
Bartłomiej Pawłowski,Zagłębie Lubin,3,3,6,1745,"581,7","290,8"
Martin Bukata,Piast Gliwice,2,3,5,1456,"728,0","291,2"
Łukasz Piątek,Bruk-Bet,6,3,9,2649,"441,5","294,3"
Łukasz Kosakiewicz,Korona Kielce,1,4,5,1485,"1485,0","297,0"
Jakub Bartkowski,Wisła Kraków,2,3,5,1485,"742,5","297,0"
Marko Vesović,Legia Warszawa,1,3,4,1191,"1191,0","297,8"
Kamil Drygas,Pogoń Szczecin,5,4,9,2713,"542,6","301,4"
Spas Delew,Pogoń Szczecin,5,2,7,2132,"426,4","304,6"
Maciej Gajos,Lech Poznań,4,5,9,2781,"695,3","309,0"
Szymon Pawłowski,Bruk-Bet,3,4,7,2179,"726,3","311,3"
Adam Gyurcso,Pogoń Szczecin,2,2,4,1267,"633,5","316,8"
Tomasz Jodłowiec,Piast Gliwice,1,5,6,1920,"1920,0","320,0"
Dominik Furman,Wisła Płock,2,7,9,2883,"1441,5","320,3"
Sergei Zenjov,Cracovia,3,2,5,1611,"537,0","322,2"
Javi Hernandez,Cracovia,5,3,8,2595,"519,0","324,4"
Arkadiusz Reca,Wisła Płock,3,5,8,2603,"867,7","325,4"
Taras Romanczuk,Jagiellonia,5,4,9,2944,"588,8","327,1"
Maciej Małkowski,Sandecja,1,3,4,1349,"1349,0","337,3"
Martin Pospisil,Jagiellonia,5,2,7,2365,"473,0","337,9"
Radosław Majewski,Lech Poznań,2,4,6,2079,"1039,5","346,5"
Mateusz Szczepaniak,Cracovia/Piast,3,2,5,1735,"578,3","347,0"
Maciej Jankowski,Piast/Arka,3,2,5,1759,"586,3","351,8"
Szymon Żurkowski,Górnik Zabrze,2,6,8,2855,"1427,5","356,9"
Konrad Michalak,Wisła Płock,1,4,5,1801,"1801,0","360,2"
Wojciech Trochim,Sandecja,6,1,7,2532,"422,0","361,7"
Ivan Jukić,Korona Kielce,4,0,4,1480,"370,0","370,0"
Marcin Warcholak,Arka Gdynia,3,1,4,1494,"498,0","373,5"
Zoran Arsenić,Wisła Kraków,3,4,7,2660,"886,7","380,0"
Marcin Cebula,Korona Kielce,2,2,4,1584,"792,0","396,0"
Rafał Boguski,Wisła Kraków,4,1,5,1996,"499,0","399,2"
Michał Koj,Górnik Zabrze,3,3,6,2399,"799,7","399,8"
Michał Chrapek,Śląsk Wrocław,1,4,5,2032,"2032,0","406,4"
Ricardo Nunes,Pogoń Szczecin,2,5,7,2855,"1427,5","407,9"
Damian Zbozień,Arka Gdynia,3,4,7,2910,"970,0","415,7"
Guilherme Sitya,Jagiellonia,0,6,6,2578,-,"429,7"
Damian Szymański,Wisła Płock,4,2,6,2598,"649,5","433,0"
Jakub Piotrowski,Pogoń Szczecin,3,2,5,2227,"742,3","445,4"
Mateusz Wieteska,Górnik Zabrze,7,0,7,3121,"445,9","445,9"
Alan Czerwiński,Zagłębie Lubin,1,5,6,2692,"2692,0","448,7"
Sito Riera,Śląsk Wrocław,0,4,4,1819,-,"454,8"
Łukasz Trałka,Lech Poznań,6,0,6,2881,"480,2","480,2"
Adam Marciniak,Arka Gdynia,2,3,5,2459,"1229,5","491,8"
Simeon Sławczew,Lechia Gdańsk,1,3,4,2001,"2001,0","500,3"
Ken Kallaste,Korona Kielce,1,4,5,2562,"2562,0","512,4"
Grzegorz Piesio,Arka Gdynia,1,3,4,2144,"2144,0","536,0"
Filip Jagiełło,Zagłębie Lubin,1,3,4,2201,"2201,0","550,3"
Bartosz Śpiączka,Bruk-Bet,3,1,4,2286,"762,0","571,5"
Patrik Mraz,Sandecja,1,3,4,2418,"2418,0","604,5"
Bartosz Rymaniak,Korona Kielce,3,2,5,3060,"1020,0","612,0"
Martin Konczkowski,Piast Gliwice,1,4,5,3275,"3275,0","655,0"
Mateusz Możdżeń,Korona Kielce,2,2,4,2622,"1311,0","655,5"
Piotr Celeban,Śląsk Wrocław,5,0,5,3330,"666,0","666,0"
Michal Piter-Bućko,Sandecja,3,1,4,2700,"900,0","675,0"
Robert Gumny,Lech Poznań,0,4,4,2889,-,"722,3"
Lasza Dwali,Pogoń Szczecin,2,2,4,2970,"1485,0","742,5"
Dani Suarez,Górnik Zabrze,4,0,4,2998,"749,5","749,5"
